Visual representation (. = background, # = text):
........................................................................................................................
........................................................................................................................
........................................................................................................................
........................................................................................................................
........................................................................................................................
........................................................................................................................
........................................................................................................................
........................................................................................................................
..........######..######..######..######..######..######..######..######..######..######..######..######..####..........
..........#.....#.#.......#.......#.......#.....#.........#.....#.#.....#.#.......#.......#.............................
..........#.....#.#.......#.......#.......#.....#.........#.....#.#.....#.#.......#.......#.............................
..........##############..#.......#.......#.....#.........#########.....#.######..#.......#.............................
..........#.....#.#.......#.......#.......#.....#.........#.....#.#.....#.#.......#.......#.............................
..........#.....#.######..######..######..#######.........#.....#.#######.#.......######..######........................
..........#.....#.#.......#.......#.......#.....#.........#.....#.#.....#.#.....#.#.......#.............................
..........#.....#.#.......#.......#.......#.....#.........#.....#.#.....#.#.....#.#.......#.............................
..........#.....#.#.......#.......#.......#.....#.........#.....#.#.....#.#.....#.#.......#.............................
..........#.....#.#.......#.......#.......#.....#.........#.....#.#.....#.#.....#.#.......#.............................
..........#.....#.#.......#.......#.......#.....#.........#.....#.#.....#.#.....#.#.......#.............................
..........#.....#.#.......#.......#.......#.....#.........#.....#.#.....#.#.....#.#.......#.............................
..........#.....#.#.......#.......#.......#.....#.........#.....#.#.....#.#.....#.#.......#.............................
..........######..######..######..######..######..######..######..######..######..######..######..######..####..........
........................................................................................................................
........................................................................................................................
........................................................................................................................
........................................................................................................................
........................................................................................................................
........................................................................................................................
........................................................................................................................
........................................................................................................................
